NO textures/yellow/yellow0.png
SO textures/yellow/yellow1.png
WE textures/yellow/yellow2.png
EA textures/yellow/yellow3.png
F 220,100,0
C 225,30,0

1111
1NW1
1111
