NO textures/yellow/yellow0.png
SO textures/yellow/yellow1.png
WE textures/yellow/yellow2.png
EA textures/yellow/yellow3.png

F 220,100,0
C 225,30,0

			1111111111
			1000000001
	    	1000000001
    		1000000001
			1000000001
1111111111111000000001
1000000000000000000001
1000N00000000000011111
10000000111000001				
100000001 1000001	   
1000000011100000111111
10000000000000001		
11111111111111111
111111  1111111
111111	1111111						